flag=Flag
allergyintolerance=AllergyIntolerance
basic=Basic
bodystructure=BodyStructure
careplan=CarePlan
careteam=CareTeam
clinicalimpression=ClinicalImpression
condition=Condition
communication=Communication
communicationrequest=CommunicationRequest
capabilitystatement=CapabilityStatement
detectedissue=DetectedIssue
device=Device
devicerequest=DeviceRequest
deviceusestatement=DeviceUseStatus
molecularsequence=MolecularSequence
diagnosticreport=DiagnosticReport
composition=Composition
documentreference=DocumentReference
documentmanifest=DocumentManifest
encounter=Encounter
familymemberhistory=FamilyMemberHistory
goal=Goal
graphdefinition=GraphDefinition
group=Group
imagingstudy=ImagingStudy
immunization=Immunization
immunizationevaluation=ImmunizationEvaluation
immunizationrecommendation=ImmunizationRecommendation
implementationguide=ImplementationGuide
linkage=Linkage
list=List
location=Location
media=Media
medicationadministration=MedicationAdministration
medicationdispense=MedicationDispense
medicationrequest=MedicationRequest
medicationstatement=MedicationStatement
medication=Medication
messageheader=MessageHeader
nutritionorder=NutritionOrder
observation=Observation
operationoutcome=OperationOutcome
organization=Organization
patient=Patient
procedure=Procedure
servicerequest=ServiceRequest
condition=Condition
provenance=Provenance
practitioner=Practitioner
practitionerrole=PractitionerRole
questionnaire=Questionnaire
questionnaireresponse=QuestionnaireResponse
relatedperson=RelatedPerson
riskassessment=RiskAssessment
auditevent=AuditEvent
specimen=Specimen
substance=Substance
valueset=Valueset
conceptmap=ConceptMap
schedule=Schedule
slot=Slot
appointment=Appointment
appointmentresponse=AppointmentResponse
namingsystem=NamingSystem
endpoint=Endpoint
subscription=Subscription
operationdefinition=OperationDefinition
healthcareservice=HealthcareService
coverage=Coverage
claim=Claim
claimresponse=ClaimResponse
binary=Binary
explanationofbenefit=ExplanationOfBenefit
coverageeligibilityrequest=CoverageEligibilityRequest
bundle=Bundle
searchparameter=SearchParameter
coverageeligibilityresponse=CoverageEligibilityResponse
enrollmentrequest=EnrollmentRequest
enrollmentresponse=EnrollmentResponse
paymentreconciliation=PaymentReconciliation
paymentnotice=PaymentNotice
devicemetric=DeviceMetric
person=Person
visionprescription=VisionPrescription
episodeofcare=EpisodeOfCare
structuredefinition=StructureDefinition
structuremap=StructureMap
supplyrequest=SupplyRequest
supplydelivery=SupplyDelivery
testscript=TestScript
testreport=TestReport
account=Account
contract=Contract
consent=Consent
library=library
eventdefinition=EventDefinition
measure=Measure
measurereport=MeasureReport
codesystem=CodeSystem
compartmentdefinition=CompartmentDefinition
task=Task
activitydefinition=ActivityDefinition
plandefinition=PlanDefinition
guidanceresponse=GuidanceResponse
requestgroup=RequestGroup
researchstudy=ResearchStudy
researchsubject=ResearchSubject
messagedefinition=MessageDefinition
adverseevent=AdverseEvent
chargeitem=ChargeItem
catalogentry=CatalogEntry
specimendefinition=SpecimenDefinition
observationdefinition=ObservationDefinition
examplescenario=ExampleScenario
terminologycapabilities=TerminologyCapabilities
invoice=Invoice
insuranceplan=InsurancePlan
organizationaffiliation=OrganizationAffiliation
verificationresult=VerificationResult
medicinalproduct=MedicinalProduct
medicinalproductauthorization=MedicinalProductAuthorization
medicinalproductcontraindication=MedicinalProductContraindication
medicinalproductindication=MedicinalProductIndication
medicinalproductinteraction=MedicinalProductInteraction
medicinalproductundesirableeffect=MedicinalProductUndesirableEffect
medicinalproductingredient=MedicinalProductIngredient
medicinalproductmanufactured=MedicinalProductManufactured
medicinalproductpackaged=MedicinalProductPackaged
medicinalproductpharmaceutical=MedicinalProductPharmaceutical
substancespecification=SubstanceSpecification
substancepolymer=SubstancePolymer
substancereferenceinformation=SubstanceReferenceInformation
substancenucleicacid=SubstanceNucleicAcid
substanceprotein=SubstanceProtein
substancesourcematerial=SubstanceSourceMaterial
biologicallyderivedproduct=BiologicallyDerivedProduct
iteminstance=ItemInstance
medicationknowledge=MedicationKnowledge
chargeitemdefinition=ChargeItemDefinition
devicedefinition=DeviceDefinition
researchdefinition=ResearchDefinition
researchelementdefinition=ResearchElementDefinition
evidence=Evidence
evidencevariable=EvidenceVariable
effectevidencesynthesis=EffectEvidenceSynthesis
riskevidencesynthesis=RiskEvidenceSynthesis